##############
#............#
#..@.........#
#............#
#............#
##############